ignore
....#...#####..##.#..##..#....#
..##.#.#.........#.#......##...
#.#.#.##.##...#.......#...#..#.
..##.............#.#.##.....#..
##......#.............#....#...
.....##..#.....##.#.......##..#
.##.....#........##...##.#....#
.##......#.#......#.....#..##.#
##....#..#...#...#...##.#...##.
##........##.#...##......#.#.#.
..#.#........#...##.....#.....#
..#.......####.#....#..#####...
.##..#..#..##.#.....###.#..#...
......###..##.....#.#.#..###.#.
..#.#...#..##.....#....#.#.....
.....#.#...#.###.#..#..........
##.....#...#.#....#..#.#.......
..#...#...#.........##......#..
......#.#...#...#..#...##.#...#
....#.................##.##....
...#......#.............#....##
##..#..#..........#...##.#.#...
....#...##....#..#.#...........
##.#.#.#...#....#........#..#.#
...###..........#...#...#..##.#
..##.......###.#......##.##....
...........#.#....#.....#.#...#
..#......##.#...##.#.#......#.#
..........#.#....#.#..#....#...
##..##...##.......#.#....#.#.##
.##..#.#..#...........#.#...#.#
#......##......#....####.#....#
..###......##...#...#.#.......#
.#.##.##....##..#..##...#......
.#....#..#........#..#.##.#.#..
..#.........#.#.###....###.#...
..#..#.#.#..#..#.##.##...####..
#..#..#......#..#.#....#.#.#.##
..#.........#...#..#.#.#..#...#
#..#......###.....##....##.....
#..#.....#.#.#.##.....##...#.#.
##..#.#...#.........#.#........
#....#.......#.....#..#..#.#...
...###.##.###.###.#####..#...#.
.....#..#.#..##...............#
..#.....###.###.#.....#.#....##
###.#.........#..#.#.#..#.#..#.
.##.........#..#..##....#.#...#
.#...#........#...#.....#....#.
####..........###....#.#.#....#
....##..###....#....#.#...#....
..............##......##..#.###
.#...........###.#.#....#......
###.#..#..#...#.........##.....
..#.....##...#.#.....##...#.##.
.###.#........#..#.#...#.#..##.
.......##....##.........##.#..#
#....#...#...##...#.#..#..#..##
...#...##..#...#...#.#....#.#.#
#.#......#.#...##......#.#...##
.#.###..#.###.#.....#.##.##.#.#
#...#............#...#.##..##..
....#..###.......#.....##....#.
.#####..#.....#.....#...#.....#
..##..#..###.......##.#........
.#...##.##.....#.##...##...#..#
......###...#....#....#........
....#...#.#....#...#.#.#......#
....#..##...##.#..#....###.....
...#...#..#.#...#....#.#..#####
####....#.....#.........#.#....
...###.#.#..#.#..##............
.##..#####..#...#..#..#.......#
.###......#.#.#..#....#.....#..
#....##.##..#.#...............#
...#.#..#........#......#....#.
#.....#....###....#..#.#.#.....
.#..#....#...#.#.....##....#...
..#.##.#.##.#..#.##.#.....#.#..
.......#.......###..###..#...#.
.#.......#..#........#.#.......
.#.#...#.....#.##..##.....#....
#.......##....#......#.....##..
.#.....#...##...#..##.....#....
....#..#.#.......#.#.#.........
..#....#....##.##..#..##.##.#..
.#...#....##...#........#....#.
#.#......#...#....#...........#
.#....#..#..###.#.....#..#.....
..#..................#.....#...
..#...###..#..####.#..#.#.#.#..
...#........##...##..##..#....#
...#.....#........##..#.....#.#
#....#.....##.##......#...##...
...#####....#..##..##...#.#....
###.........#.#..#..#..##.#...#
##...#..##...#.##.#........#...
.#....#.#...#..#...#..#.#......
.#......##.#...#...#..#....#...
#..#.#.#......##.##.####..#....
.#...#.#.##...##.#...#...#.....
####.#.........#...##..##....##
.....###........###.##...#.#...
.##.....#.....#....##.....##...
.#.#...#####....##...##.....#..
....###..........#......##..#.#
..#.....#....#..#...#.....##..#
...##.##.#.######....#.#....##.
...#.#.#...#..#....##.........#
.#.#...##...#....#.#....##.....
...#..#.....#.....#.##.....#...
.#.#.#.....#.##.#....#.#....##.
#...#......###...#..###...#....
...##.#.#..#........##.......#.
.####.####......#........#.....
....#..#####....#......####....
#...##.#..#..#####.#...#......#
#.#....#..#.........###........
.##.........#....#......#.#....
...###.........####.#........##
..#..#........#.#..##......#..#
.##..#....#...##.####.#...#....
......#.......#..#..#.#.##.#...
.###....#.#...#.#.......##..#.#
#...#....#............#####....
...#.##......#####..#........#.
..#...##.....#...#..#.#........
...#.#...#...##...#..#....#....
..#..##.....#....#.#.###.......
.......##..#...#.............##
.....#.....#..##.##.....#......
.....##...#......#..##....#.###
.#...#.#.#.#.##.....##..###..#.
....##..........#.....###......
....#...#.#.#..#.......#....#..
..###...#...........##..###....
...#.##.......#....#....#.#....
##...#..##..#.##..........##..#
.##.....#..#......##..####.#.##
....##..#.#.###......#..#...#..
####..#.#....#...#....###.#.#..
###......#...##.##..#.##..#..#.
..#.#..#.#.#.....#...#..#.####.
.###.#...##...##....##......#.#
..#............#.##..#....#..#.
###.......#......###..#........
....##......###.....#.#..###...
..#...##...#......#..#.........
#..####.#....#.....###....#.#..
.#.#.#.......##....###.........
.......#.##.#####....#.#...####
.#...#....#....#.###..#.....#..
.###.#.#.###.###.#..####.##.#..
....#.........#.#.......##.....
#..#..#.#...........#.#.##..#.#
.#.....#..#...#.....#.##......#
..###.#............#.....####..
#.....##..##...#....####....#..
...#.....#..................#..
....#.###.#..#..#..##..#..##...
...##.#........#......#...##...
#................##....#...#...
..##......##.#.##..#....#.....#
.#..#.....#..........##.#.#....
.....#...####....#..#......#...
..#......###.#.#.#.#.......#..#
.##......#.......#....###.#....
#..#.#.#..#...#.#.##..##..#....
....#...##..#.#......#.##...#..
...###...#.##..#...#....#......
##......#.#...#.#.#.........#..
..#..........#...###.#.##....#.
...##.....#.....#...###..#.....
..####.#.....#.#.....#..#.#....
.#.....##...##.##.#.....#.####.
.......#.....#...##..........#.
.#...#.#....#####....###.#..#.#
.##.##....##...##.#.....#......
#......#.##..#..##.#.#.......#.
.#..#....###..#........##...#..
..#......##.......###..##...#..
.#..........#.#.......##.....#.
....##.....##.#.#.##........##.
..#.#..###..#..##...#.##...#...
.......#.....#..#...#...#.....#
##.#...#.#.#.##........#......#
..###.....##..#....#.......##..
#####..####...#.#..##.#...#..#.
#...####....#........#....#....
.#.#.#..#...##....#.......#.#..
...#....##..##..#..#..#####.###
...#......#.#..#......#...####.
.##.....##.##.#.####.#..##...#.
....#..#..##..##....#....#...##
##.###........#...##....#.....#
..#.#.#.......#....#..#....#...
......##.....##....#...#.....#.
#.#..#.#.......#....#.#.#......
.....###..#...#.....#..##..#...
......###.....#.#.#...#...##..#
.#..#.#....##...#...#........#.
#..###.#...####.#...#..........
.#.##.#..#..##..#..###..##...#.
.......#.#..........#.........#
#......###..##..#....###.......
..#............#.#........#...#
..##.#.............#......#..##
.#....#..#.#..#....###..#...#..
....##....#..##...###....#....#
.#....###.............#........
#..#...#..#....#.##.#.....##...
...........#.....#....#....#...
.##.##.#...#....##......##..##.
......#.#.##.#..##........#...#
....##...##...#...#...#.#......
.#...#....#...#......#.#...#..#
........##.....#.#..#...##..##.
##...#.....#.....####...#..#...
.#.#..##.##......#...#.#...#...
##...##.#......#....#.######.#.
##.....####.###......#.##.#....
.#.##....##........#...#..####.
.......#..#....##...#.#...#..#.
...##..........#..#........#..#
.##.....#...#...#.##.###.......
.##....#...#.#..#.....#...#....
..#...#.....#.####.#.........#.
#...#.##...#.#..#.#..#.###.#..#
.##..#.#.##.........####....###
.#..##........#..#.......#.....
......#.#####.#.........#.#...#
......#....#.#####...........#.
..##....##..#.#..#....#......##
#.#......#.##.#.##....#....#.#.
..#..##.#...#.......##.........
.....##.#...#..........#.......
...#........#..#...#.....##.###
....##.........#...#.#.....#...
.......#.#....#...#.......#...#
.#..#...##....#..#...........#.
.#....##.##.#..#..####.#.#.....
.##........#.....#..#......##..
.#..##......#......#..##..#....
###.....##.......#..##.#.......
.....##......#.#...##...##.....
.##....##..#..#####...#...#.##.
##...##.#....##.#.#.#....##....
.#.....#...#......#......##....
##.#............#...#....#.....
#..#.....#.....##.##.##..#..##.
......#..............#..#...#.#
....#.#....##......#..#...#....
.#...#..#...#......#..##....#.#
.....#......#..##...#.#....#...
#...............#.##..#......#.
.....#..##.#..#.#...###.....#..
...#..#..#...#....#..#..##.#...
.#...#...#..#......##...#......
....###............#.#.#....#..
#.#...#..#..#.#....#........#..
....#.#.#..#..#....#..#...##.#.
.#....#.#...#....#......#.#...#
##..#.#.#..#.....#...###....#.#
.##.....#.#...#..........#..#.#
#....#......#....#.#.#...#.....
#.#.....#.###.......#..#..#.#..
#.....##..#.###...#...##...#.##
.#.##....#.#.....##......###...
.#.......##................#...
.........#........####......#..
...##.###..#.....#.#.....##.#..
..#....#.#.#.##..........#.....
#..##.....#.............##.....
.##...#..#.......#.......#..#..
...#.................#......##.
....#....#.....#..###.#....###.
..#.#..#...#..#.....###....#.#.
.....###...#....#....#.#.##..##
...#...#.........####........#.
.......#..##.........#.........
.#......##.....#.#####...##....
....#.###...#.#....##..#......#
.##..#....#.#....#..#.###.....#
..#...#.#...#.##.....#.#....##.
#.#.#.#.....##...#.#..##..#....
.#............#.#.#..#...#...#.
...##.#..#..####.#.###..##.....
.##.....#.......#..##.#...##.#.
#.#...#..#.##...##...####..#..#
...##.......#.#.#.#.#.#...#..##
...#.#.##..##..............###.
.....#...#........#...#......#.
..#..#..##....#..##.#.....#....
#.....##........#.........##.#.
###..#....#.##..##.............
.#..#...#.#......#..#..##.....#
...#.#.#............##........#
..#.#....#..#....##....#...##.#
...##...#...#..........##.#####
....#..#.#.......##....#.#.###.
##..#..#..#...###.#.....#......
....###.#.#.#.##..##.#...#.....
.....####..#.#..#.#......#.#.#.
#.....#...#..#.#.........#..#..
.##....#.#.####......##..#..##.
......#.##.#.#..#..#....#.#....
.#..#...#...#...#..#.....#.....
..##.#..............#......#...
.....###.##.......#.....#..#...
..#.#..#..#.......#...##.##..#.
##.###......#......#.#..#..##..
..##.....#..#..#......#..#.....
...##.......#.#..#.........#.#.
......##.##.#.......#..#.#.....
#......#........##..#.......#.#
###....#...#...#.#...#..#..#...
#..###....#....####..#...#.....
....##..#.##.#....#..##...#.#..
#.##..#....##..#...#..#.#.#..#.
#.........#.....#...#.......#..
...#.....#.#.....#........##...
..#.##..#......#...#.....##.#..
...###....#.....#...#..#.##..#.
